00000000000000000000000000000000000000000000000000000000005000000000000000000000000000000000000000000000000000000000000000000000000000000000000000000000000000000000000000000000
00000000000000000000000000000000000000000000000000000000022200000000000000000000000000000000000000000000000000000000000000000000000000000000000000000000000000000000000000000000
00000000000000000045400000000000000000000000000000000000000000000000000000000000000000000000000000000000000000000000000000000000000000000000000000000000000000000000000000000000
00000000000000000222220000000000000000000000000000000004000004000000000000000000000000000000000000000000000000000000000000444000044400004440000000000000000000000000000000000000
00000000000000000000000000000000000000000000000000000022200022200000000000000000000000000000000000000000000000000000000032222200222220022222003000000000000330000000000000000000
00000000000000300000000000000000000000000000000000000000000000000000000000000000000000000000000000000000000000000000000030000000000000000000003300000000003330000000000000000000
00000000000003300000000000000000000000000000000000004000000000004000000000000000000000000000000000000000000000000000000030000000000000000044403330000000033330000000000000000000
00000000000033300000000040000000000000000000000000022200000000022200000000000000000000000003000003000000000000000000000000000000000000000222223333000000333330000000000000000000
00000000000333300000000333000030000300000000000000000000000000000000000000000000000000000003000003000000000000000000000000000000000000000000003333300003333330000000000000000000
00000000003333304040400000000030440300000400400000044400044400044400000000400004000040000003044403000004000040004000400004440000004440000044403333330033333330000000000000000000
22222222222222222222220000022222222222200200200222222222222222222222222003330033300333002222222222222033300333022203330222222222222222222222222222222222222220002222222222222222
11111111111111111111110000011111111111100100100111111111111111111111111000000000000000001111111111111000000000011100000111111111111111111111111111111111111110001111111111111111
11111111111111111111110000011111111111100100100111111111111111111111111000000000000000001111111111111000000000011100000111111111111111111111111111111111111110001111111111111111
11111111111111111111110000011111111111100100100111111111111111111111111000000000000000001111111111111000000000011100000111111111111111111111111111111111111110001111111111111111
11111111111111111111110000011111111111100100100111111111111111111111111000000000000000001111111111111000000000011100000111111111111111111111111111111111111110001111111111111111